11111111
10100001
10100101
10001101
10010001
11111111
