########
#.#....#
#.#..#.#
#...##.#
#..#...#
########
