11111111111111111
10000000000110011
10111101110010011
10000011111000001
10000000000000111
10000011111101111
10000011110001111
10000001110011111
11111100000011111
11100101111111111
11101101111111111
11100000011111111
10001100000000111
10111110000000111
11111111111111111