#################
#..........##..##
#.####.###..#..##
#.....#####.....#
#.............###
#.....######.####
#.....####...####
#......###..#####
######......#####
###..#.##########
###.##.##########
###......########
#...##........###
#.#####.......###
#################