#################
#..........#....#
#..........###..#
###..........#..#
###.............#
###.............#
#...............#
#.......####....#
#...............#
#............####
#...............#
#.....#......####
#...............#
#...............#
#################